b a a a a a a a a y
a b a a a a a a a y
a a b a a a a a a y
a a a b a a a a a a
a a a a b a a a a a
a a a a b a a a a a
b a a a a a a a a y
a b a a a a a a a y
a a b a a a a a a y
a a a b a a a a a a
a a a a b a a a a a
a a a a b a a a a a